20 13*
B B B B B B B B B B B B B B B B B B B B:
B E E E E E E E E E E E E E E E E E E B:
B E R R E E E E E E E E E E E E E E E B:
B E E R R E E Y Y Y Y E G G G E E E E B:
B E E E E E E Y Y E E E E G E E E E E B:
B E E E E E E E Y E E E E G E E E E E B:
B E C E E E G E Y E E E E E E R R E E B:
B E E E E E G E Y E E E E E E E R E E B:
B E E E E G G E E E E E E E E E R R E B:
B E E E E G E E E E G G G G E E E E E B:
B E E E E E E E E E E E E E E E E E E B:
B E E E E E E E E E E E E E E E E E E B:
B B B B B B B B B B B B B B B B B B B B: